12,e
0,0 0,0 0,0 0,0 0,0 0,0 3,0 f,1 f,1 f,1 f,1 c,1 0,0 0,0 
0,0 0,0 0,0 0,0 0,0 0,0 3,0 f,1 f,1 f,1 f,1 c,1 0,0 0,0 
0,0 0,0 0,0 0,0 0,0 0,0 3,0 f,1 f,1 f,1 f,1 c,1 0,0 0,0 
0,0 0,0 0,0 0,0 0,0 0,0 3,0 f,1 f,1 f,1 f,1 c,1 0,0 0,0 
0,0 0,0 0,0 0,0 0,0 0,0 1,0 b,1 f,1 f,1 f,1 c,1 0,0 0,0 
0,0 0,0 0,0 0,0 0,0 0,0 0,0 3,0 f,1 f,1 f,1 c,1 0,0 0,0 
0,0 0,0 0,0 0,0 0,0 0,0 0,0 1,0 b,1 f,1 f,1 e,1 4,0 0,0 
0,0 0,0 0,0 0,0 0,0 0,0 0,0 0,0 3,0 f,1 f,1 f,1 c,1 0,0 
0,0 0,0 0,0 0,0 0,0 0,0 0,0 0,0 1,0 b,1 f,1 f,1 c,1 0,0 
0,0 0,0 0,0 0,0 0,0 0,0 0,0 0,0 0,0 3,0 f,1 f,1 c,1 0,0 
0,0 0,0 0,0 0,0 0,0 0,0 0,0 0,0 0,0 3,0 f,1 d,1 8,1 0,0 
0,0 0,0 0,0 0,0 0,0 0,0 0,0 0,0 2,0 7,0 f,1 c,1 0,0 0,0 
0,0 0,0 0,0 0,0 0,0 0,0 0,0 0,0 3,0 f,1 f,1 c,1 0,0 0,0 
0,0 0,0 0,0 0,0 0,0 0,0 0,0 0,0 3,0 f,1 f,1 c,1 0,0 0,0 
0,0 0,0 0,0 0,0 0,0 0,0 0,0 0,0 1,0 b,1 f,1 c,1 0,0 0,0 
0,0 0,0 0,0 0,0 0,0 0,0 0,0 0,0 0,0 3,0 f,1 c,1 0,0 0,0 
0,0 0,0 0,0 0,0 0,0 0,0 0,0 0,0 0,0 1,0 9,1 8,1 0,0 0,0 
0,0 0,0 0,0 0,0 0,0 0,0 0,0 0,0 0,0 0,0 0,0 0,0 0,0 0,0 
1
77:((100.000000 280.000000 )(50.000000 70.000000 ));(0.000000 30.000000 );(0| 0 );((-0.000000 -0.500000 )0 );(0 1 0 0 1 -1.000000 -0.016667 0.000000 0.000000 (1.000000 0.000000 )0 (0.000000 0.000000 ));((255 24 24 255 ));
